+---------------------------------------------+         +---------------------------------------------+         +---------------------------------------------+         +---------------------------------------------+
|.............................................|         |.............................................|         |.............................................|         |.............................................|
|.............................................|         |.............................................###########.............................................###########.............................................|
|.............................................##        |.............................................|         |............+--------------------------------+         |.............................................|
#.............................................|##########............+--------------------------------+         |............|                                          |..........+-----------------------+..........|
|..............+------------------------------+#        |............|                                          |............+--------------------------------+         |..........|                       |..........|
|..............|                               #        |............|                                          |.............................................|         |..........|                       |..........|
|..............|                               #        |............+--------------------------------+         |.............................................|         |..........|                       |..........|
|..............|                               ##########.............................................|         |.............................................|         |..........|                       |..........|
|..............|                               #        |.............................................###########.............................................|         |..........|                       |..........|
#..............#################################        |.............................................|         |.............................................|         |..........|                       |..........|
|..............|                              #         |.............................................|         +--------------------------------+............|         |..........|                       |..........|
|..............|                              #         +--------------------------------+............|                                          |............|         |..........|                       |..........|
|..............|                              ##                                         |............|                                          |............|         |..........|                       |..........|
|..............+------------------------------+#                                         |............|                                          |............|         |..........|                       |..........|
|.............................................##        +--------------------------------+............|         +--------------------------------+............#         |..........+-----------------------+..........|
#.............................................|         |.............................................|         |.............................................|         |.............................................|
|.............................................|         |.............................................|         |.............................................|         |.............................................|
|.............................................|         |.............................................###########.............................................|         |.............................................|
+---------------------------------------------+         +---------------------------------------------+         +---------------------------------------------+         +---------------------------------------------+
